1,8,8,7,7,7,7,7,8,8,1,1
1,8,8,7,7,6,7,7,8,8,1,1
1,8,8,7,7,6,7,7,8,8,1,1
1,8,8,7,7,6,7,7,8,8,1,1
1,8,8,7,7,6,7,7,8,8,1,1
1,8,8,7,7,6,7,7,8,8,1,1
1,3,3,2,2,-16,2,2,3,3,1,1
1,3,3,2,2,1,2,2,3,3,1,1
1,3,3,2,2,1,2,2,3,3,1,1
1,3,3,2,2,1,2,2,3,3,1,1
1,3,3,2,2,-1,2,2,3,3,1,1
1,3,3,2,2,2,2,2,3,3,1,1