7,7,7,7,7,7,7,7,7,7,7,7
7,-7,-2,6,6,6,6,6,6,6,6,7
7,6,6,6,6,6,6,6,6,6,6,7
7,6,6,6,6,6,6,6,6,6,6,7
7,6,6,6,6,6,6,6,6,6,6,7
7,6,6,6,6,6,6,6,6,6,6,7
7,6,6,6,6,6,6,6,6,6,6,7
7,6,6,6,6,6,6,6,6,6,6,7
7,6,6,6,7,10,7,7,7,7,7,7
7,6,6,6,7,8,7,8,8,8,8,7
7,6,6,6,7,8,8,8,8,8,9,7
7,7,7,7,7,7,7,7,7,7,7,7