7,7,7,7,7,7,7,7,7,7,7,7
7,-7,-2,6,6,6,6,6,6,6,6,7
7,6,6,6,6,6,6,6,6,6,6,7
7,6,6,6,6,6,6,6,6,6,6,7
7,6,6,6,6,6,6,6,6,6,6,7
7,6,6,6,6,6,6,6,6,6,6,7
7,6,6,6,6,6,6,6,6,6,6,7
7,6,6,6,6,6,6,6,6,6,6,7
7,6,6,6,6,6,6,6,6,6,6,7
7,6,6,6,6,6,6,6,6,6,6,7
7,6,6,6,6,6,6,6,6,6,9,7
7,7,7,7,7,7,7,7,7,7,7,7