2,2,2,2,2,2,2,2,2,2,2,2
2,1,1,1,1,5,5,5,1,1,1,2
2,1,1,1,5,5,-21,5,5,1,1,2
2,1,1,1,5,-21,-6,-21,5,1,1,2
2,1,1,1,5,5,-21,5,5,1,1,2
2,1,1,1,1,5,5,5,1,1,1,2
2,1,1,1,1,2,1,2,1,1,1,2
2,1,1,1,1,2,1,2,1,1,1,2
2,1,1,1,1,2,1,2,1,1,1,2
2,1,1,1,1,2,1,2,1,1,1,2
2,1,1,1,1,2,-1,2,1,1,1,2
2,2,2,2,2,2,2,2,2,2,2,2